คุณสมบัติเด่นของเครื่อง
 
 CPU - หน่วยประมวลผล	Intel Pentium N3540 (2.16GHz, 2MB L3 Cache)
	
 GPU - การ์ดจอ แสดงผล	Intel HD Graphics
	
 Chipset	Mobile Intel Express Chipset
	
 หน่วยความจำ	8 GB DDR3
	
 ฮาร์ดดิส	500 GB 5400 รอบต่อนาที
	
 ออปติคอลไดรฟ์	ไม่มี
	
 ระบบปฏิบัติการ	Linux
	
 แบตเตอรี่	3 Cell Li-ion ใช้งานได้ต่อเนื่องประมาณ 3-4 ชั่วโมง
	
 ขนาด	ไม่ระบุ
	
 น้ำหนัก	1.29 กิโลกรัม
	
คุณสมบัติการแสดงผล
 
 หน้าจอแสดงผล	13.3 นิ้ว แบบ WXGA LED Backlight ความละเอียดระดับ (1366x768 Pixel) อัตราส่วน 16:9
	
 GPU - การ์ดจอ แสดงผล	Intel HD Graphics
	
คุณสมบัติทางด้านเสียง
 
 ลำโพง	มีในตัว
	
 ระบบเสียง	มีในตัว
	
 ไมโครโฟน	มีในตัว
	
คุณสมบัติการเชื่อมต่อ
 
 ไวร์เลสแลน	มีในตัว
	
 บลูทูธ	มีในตัว
	
 ยูเอสบี	2 Port : 1 Port เวอร์ชั่น 2.0, 1 Port เวอร์ชั่น 3.0
	
 ช่องต่อหูฟัง	มีในตัว
	
 ช่องต่อไมโครโฟน	มีในตัว
	
 IEEE 1394 (ไฟร์ไวร์)	ไม่ระบุ
	
 Card Reader	มีในตัว
	
 RJ-11 (โมเด็ม)	ไม่มี
	
 RJ-45 (แลน)	ไม่ระบุ
	
 PCMCIA Card Slot	ไม่มี
	
 Express Card slot	ไม่มี
	
 HDMI	มีในตัว
	
 DVI	ไม่มี
	
 D-SUB	ไม่ระบุ
	
 S-Video	ไม่มี
	
 e-SATA	ไม่ระบุ
	
คุณสมบัติอื่นๆ
 
 กล้องเว็บแคม	Bulit In Web Camera HD
	
 สแกนลายนิ้วมือ	ไม่ระบุ
	
 การรับประกัน	1 Year