คุณสมบัติเด่นของเครื่อง
 
 CPU - หน่วยประมวลผล	Intel Core i3-4005U (1.70GHz) 3MB L3 Cache
	
 GPU - การ์ดจอ แสดงผล	nVidia GeForce GT 820M หน่วยความจำ 2GB
	
 Chipset	ไม่ระบุ
	
 หน่วยความจำ	4 GB DDR3
	
 ฮาร์ดดิส	1 TB 5400 รอบต่อนาที
	
 ออปติคอลไดรฟ์	DVD Super Multi Dual-Layer
	
 ระบบปฏิบัติการ	Linux
	
 แบตเตอรี่	ไม่ระบุ
	
 ขนาด	ไม่ระบุ
	
 น้ำหนัก	2.30 กิโลกรัม
	
คุณสมบัติการแสดงผล
 
 หน้าจอแสดงผล	14 นิ้ว แบบ WXGA LED Backlight ความละเอียดระดับ (1366x768 Pixel) อัตราส่วน 16:9
	
 GPU - การ์ดจอ แสดงผล	nVidia GeForce GT 820M หน่วยความจำ 2GB
	
คุณสมบัติทางด้านเสียง
 
 ลำโพง	Built-In Stereo Speakers
	
 ระบบเสียง	มีในตัว
	
 ไมโครโฟน	มีในตัว
	
คุณสมบัติการเชื่อมต่อ
 
 ไวร์เลสแลน	WiFi 802.11 b/g/n
	
 บลูทูธ	มีในตัว
	
 ยูเอสบี	3 Port : 2 Port เวอร์ชั่น 2.0, 1 Port เวอร์ชั่น 3.0
	
 ช่องต่อหูฟัง	มีในตัว
	
 ช่องต่อไมโครโฟน	มีในตัว
	
 IEEE 1394 (ไฟร์ไวร์)	ไม่ระบุ
	
 Card Reader	มีในตัว
	
 RJ-11 (โมเด็ม)	ไม่มี
	
 RJ-45 (แลน)	มีในตัว
	
 PCMCIA Card Slot	ไม่ระบุ
	
 Express Card slot	ไม่ระบุ
	
 HDMI	มีในตัว
	
 DVI	ไม่มี
	
 D-SUB	ไม่ระบุ
	
 S-Video	ไม่มี
	
 e-SATA	ไม่ระบุ
	
คุณสมบัติอื่นๆ
 
 กล้องเว็บแคม	1.3 Mega Pixel
	
 สแกนลายนิ้วมือ	ไม่มี
	
 การรับประกัน	2 Years