คุณสมบัติเด่นของเครื่อง
 
 CPU - หน่วยประมวลผล	Intel Core i5-4200U (1.60GHz Turbo Boost up to 2.60GHz) 3MB L3 Cache
	
 GPU - การ์ดจอ แสดงผล	Intel HD Graphics 4400
	
 Chipset	ไม่ระบุ
	
 หน่วยความจำ	4 GB DDR3
	
 ฮาร์ดดิส	128GB แบบ SSD
	
 ออปติคอลไดรฟ์	ไม่มี
	
 ระบบปฏิบัติการ	Windows 8.1 64bit
	
 แบตเตอรี่	มีในตัว : ใช้งานได้ต่อเนื่องประมาณ 9 ชั่วโมง
	
 ขนาด	ไม่ระบุ
	
 น้ำหนัก	1.39 กิโลกรัม
	
คุณสมบัติการแสดงผล
 
 หน้าจอแสดงผล	13.3 นิ้ว แบบ IPS LED Backlight ความละเอียดระดับ (3200x1800 Pixel) รองรับการใช้งานระบบสัมผัส
	
 GPU - การ์ดจอ แสดงผล	Intel HD Graphics 4400
	
คุณสมบัติทางด้านเสียง
 
 ลำโพง	Built-In Stereo Speakers : Stereo Speakers
	
 ระบบเสียง	มีในตัว : Dolby Home Theater
	
 ไมโครโฟน	มีในตัว
	
คุณสมบัติการเชื่อมต่อ
 
 ไวร์เลสแลน	WiFi 802.11 b/g/n
	
 บลูทูธ	มีในตัว
	
 ยูเอสบี	2 Port : 1 Port เวอร์ชั่น 2.0, 1 Port เวอร์ชั่น 3.0
	
 ช่องต่อหูฟัง	มีในตัว
	
 ช่องต่อไมโครโฟน	มีในตัว
	
 IEEE 1394 (ไฟร์ไวร์)	ไม่ระบุ
	
 Card Reader	มีในตัว
	
 RJ-11 (โมเด็ม)	ไม่มี
	
 RJ-45 (แลน)	ไม่ระบุ
	
 PCMCIA Card Slot	ไม่มี
	
 Express Card slot	ไม่มี
	
 HDMI	มีในตัว : รองรับการเชื่อมต่อผ่าน Mini HDMI
	
 DVI	ไม่มี
	
 D-SUB	ไม่มี
	
 S-Video	ไม่มี
	
 e-SATA	ไม่มี
	
คุณสมบัติอื่นๆ
 
 กล้องเว็บแคม	Bulit In Web Camera HD
	
 สแกนลายนิ้วมือ	ไม่มี
	
 การรับประกัน	1 Year