คุณสมบัติเด่นของเครื่อง
 
 CPU - หน่วยประมวลผล	Intel Core i7-3630QM (2.40GHz Turbo Boost up to 3.40GHz) 6MB L3 Cache
	
 GPU - การ์ดจอ แสดงผล	nVidia GeForce GT 650M หน่วยความจำ 2GB & nVidia GeForce GT 650M หน่วยความจำ 2GB
	
 Chipset	Mobile Intel HM76 Express Chipset
	
 หน่วยความจำ	8 GB DDR3
	
 ฮาร์ดดิส	1TB 5400 รอบต่อนาที
	
 ออปติคอลไดรฟ์	DVD Writer (Dual Layer Support)
	
 ระบบปฏิบัติการ	Dos Operating System
	
 แบตเตอรี่	6 Cell Li-ion ใช้งานได้ต่อเนื่องประมาณ 3 ชั่วโมง
	
 ขนาด	ไม่ระบุ
	
 น้ำหนัก	2.70 กิโลกรัม
	
คุณสมบัติการแสดงผล
 
 หน้าจอแสดงผล	15.6 นิ้ว แบบ WUXGA LED Backlight ความละเอียดระดับ (1920x1080 Pixel) อัตราส่วน 16:9
	
 GPU - การ์ดจอ แสดงผล	nVidia GeForce GT 650M หน่วยความจำ 2GB & nVidia GeForce GT 650M หน่วยความจำ 2GB
	
คุณสมบัติทางด้านเสียง
 
 ลำโพง	Built-In Stereo Speakers : Dolby Home Theater v4
	
 ระบบเสียง	มีในตัว : JBL Speakers With 2.0
	
 ไมโครโฟน	มีในตัว
	
คุณสมบัติการเชื่อมต่อ
 
 ไวร์เลสแลน	WiFi 802.11 b/g/n
	
 บลูทูธ	มีในตัว
	
 ยูเอสบี	3 Port : 1 Port เวอร์ชั่น 2.0, 2 Port เวอร์ชั่น 3.0
	
 ช่องต่อหูฟัง	มีในตัว
	
 ช่องต่อไมโครโฟน	มีในตัว
	
 IEEE 1394 (ไฟร์ไวร์)	ไม่ระบุ
	
 Card Reader	6 In 1
	
 RJ-11 (โมเด็ม)	ไม่มี
	
 RJ-45 (แลน)	มีในตัว
	
 PCMCIA Card Slot	ไม่ระบุ
	
 Express Card slot	ไม่ระบุ
	
 HDMI	มีในตัว
	
 DVI	ไม่มี
	
 D-SUB	มีในตัว
	
 S-Video	ไม่มี
	
 e-SATA	ไม่ระบุ
	
คุณสมบัติอื่นๆ
 
 กล้องเว็บแคม	Bulit In Web Camera HD
	
 สแกนลายนิ้วมือ	ไม่มี
	
 การรับประกัน	2 Years