 CPU - หน่วยประมวลผล	Intel Core i3-4005U (1.70GHz) 3MB L3 Cache
	
 GPU - การ์ดจอ แสดงผล	Intel HD Graphics 4400
	
 Chipset	Mobile Intel Express Chipset
	
 หน่วยความจำ	4 GB DDR3
	
 ฮาร์ดดิส	500 GB 5400 รอบต่อนาที
	
 ออปติคอลไดรฟ์	DVD Writer (Dual Layer Support)
	
 ระบบปฏิบัติการ	Linux Ubuntu
	
 แบตเตอรี่	มีในตัว  ใช้งานได้ต่อเนื่องประมาณ 2-4 ชั่วโมง
	
 ขนาด	ไม่ระบุ
	
 น้ำหนัก	1.99 กิโลกรัม
	
คุณสมบัติการแสดงผล
 
 หน้าจอแสดงผล	14 นิ้ว แบบ WXGA LED Backlight ความละเอียดระดับ (1366x768 Pixel) อัตราส่วน 169
	
 GPU - การ์ดจอ แสดงผล	Intel HD Graphics 4400
	
คุณสมบัติทางด้านเสียง
 
 ลำโพง	Built-In Stereo Speakers
	
 ระบบเสียง	มีในตัว
	
 ไมโครโฟน	มีในตัว
	
คุณสมบัติการเชื่อมต่อ
 
 ไวร์เลสแลน	WiFi 802.11 bgn
	
 บลูทูธ	มีในตัว
	
 ยูเอสบี	3 Port  2 Port เวอร์ชั่น 2.0, 1 Port เวอร์ชั่น 3.0
	
 ช่องต่อหูฟัง	มีในตัว
	
 ช่องต่อไมโครโฟน	มีในตัว
	
 IEEE 1394 (ไฟร์ไวร์)	ไม่ระบุ
	
 Card Reader	3 In 1
	
 RJ-11 (โมเด็ม)	ไม่มี
	
 RJ-45 (แลน)	มีในตัว
	
 PCMCIA Card Slot	ไม่ระบุ
	
 Express Card slot	ไม่ระบุ
	
 HDMI	มีในตัว
	
 DVI	ไม่มี
	
 D-SUB	ไม่ระบุ
	
 S-Video	ไม่มี
	
 e-SATA	ไม่ระบุ