คุณสมบัติเด่นของเครื่อง
 
 CPU - หน่วยประมวลผล	Intel Core i5-5200U (2.20GHz Turbo Boost up to 2.70GHz) 3MB L3 Cache
	
 GPU - การ์ดจอ แสดงผล	nVidia GeForce GT 840M หน่วยความจำ 2 GB
	
 Chipset	Mobile Intel Express Chipset
	
 หน่วยความจำ	4 GB DDR3
	
 ฮาร์ดดิส	1 TB 5400 รอบต่อนาที + 8 GB [SSD]
	
 ออปติคอลไดรฟ์	DVD Super Multi Dual-Layer
	
 ระบบปฏิบัติการ	Windows 8.1 64bit
	
 แบตเตอรี่	4 Cell Li-ion ใช้งานได้ต่อเนื่องประมาณ 3-4 ชั่วโมง
	
 ขนาด	ไม่ระบุ
	
 น้ำหนัก	2.08 กิโลกรัม
	
คุณสมบัติการแสดงผล
 
 หน้าจอแสดงผล	14 นิ้ว แบบ diagonal HD BrightView LED-backlit Touch Screen ความละเอียดระดับ (1366x768 Pixel) อัตราส่วน 16:9
	
 GPU - การ์ดจอ แสดงผล	nVidia GeForce GT 840M หน่วยความจำ 2 GB
	
คุณสมบัติทางด้านเสียง
 
 ลำโพง	Built-In Stereo Speakers
	
 ระบบเสียง	มีในตัว
	
 ไมโครโฟน	มีในตัว
	
คุณสมบัติการเชื่อมต่อ
 
 ไวร์เลสแลน	WiFi 802.11 b/g/n
	
 บลูทูธ	มีในตัว
	
 ยูเอสบี	3 Port : 1 Port เวอร์ชั่น 2.0, 2 Port เวอร์ชั่น 3.0
	
 ช่องต่อหูฟัง	มีในตัว
	
 ช่องต่อไมโครโฟน	มีในตัว
	
 IEEE 1394 (ไฟร์ไวร์)	ไม่ระบุ
	
 Card Reader	Multi-in-1
	
 RJ-11 (โมเด็ม)	ไม่มี
	
 RJ-45 (แลน)	มีในตัว
	
 PCMCIA Card Slot	ไม่ระบุ
	
 Express Card slot	ไม่ระบุ
	
 HDMI	มีในตัว
	
 DVI	ไม่มี
	
 D-SUB	ไม่ระบุ
	
 S-Video	ไม่มี
	
 e-SATA	ไม่ระบุ
	
คุณสมบัติอื่นๆ
 
 กล้องเว็บแคม	Bulit In Web Camera HD
	
 สแกนลายนิ้วมือ	ไม่มี
	
 การรับประกัน	1 Year