คุณสมบัติเด่นของเครื่อง
 
 CPU - หน่วยประมวลผล	Intel Core i5-4210U (1.70GHz Turbo Boost up to 2.70GHz) 3MB L3 Cache
	
 GPU - การ์ดจอ แสดงผล	Intel HD Graphics 4400
	
 Chipset	Mobile Intel HM86 Express Chipset
	
 หน่วยความจำ	4 GB DDR3
	
 ฮาร์ดดิส	128GB แบบ SSD
	
 ออปติคอลไดรฟ์	ไม่มี
	
 ระบบปฏิบัติการ	Windows 8.1 64bit
	
 แบตเตอรี่	6 Cell Li-ion ใช้งานได้ต่อเนื่องประมาณ 4-6 ชั่วโมง
	
 ขนาด	ไม่ระบุ
	
 น้ำหนัก	1.34 กิโลกรัม
	
คุณสมบัติการแสดงผล
 
 หน้าจอแสดงผล	12.5 นิ้ว แบบ WUXGA LED Backlight Anti-Glare ความละเอียดระดับ (1920x1080 Pixel) อัตราส่วน 16:9
	
 GPU - การ์ดจอ แสดงผล	Intel HD Graphics 4400
	
คุณสมบัติทางด้านเสียง
 
 ลำโพง	Built-In Stereo Speakers
	
 ระบบเสียง	มีในตัว : High Definition Audio
	
 ไมโครโฟน	มีในตัว
	
คุณสมบัติการเชื่อมต่อ
 
 ไวร์เลสแลน	WiFi 802.11a/b/g/n
	
 บลูทูธ	มีในตัว
	
 ยูเอสบี	3 Port : เวอร์ชัน 2.0
	
 ช่องต่อหูฟัง	มีในตัว
	
 ช่องต่อไมโครโฟน	มีในตัว
	
 IEEE 1394 (ไฟร์ไวร์)	ไม่ระบุ
	
 Card Reader	ไม่ระบุ
	
 RJ-11 (โมเด็ม)	ไม่มี
	
 RJ-45 (แลน)	ไม่มี
	
 PCMCIA Card Slot	ไม่มี
	
 Express Card slot	ไม่มี
	
 HDMI	มีในตัว
	
 DVI	ไม่มี
	
 D-SUB	ไม่ระบุ
	
 S-Video	ไม่มี
	
 e-SATA	ไม่มี
	
คุณสมบัติอื่นๆ
 
 กล้องเว็บแคม	1.3 Mega Pixel
	
 สแกนลายนิ้วมือ	ไม่มี
	
 การรับประกัน	2 Years